"Revenue...K.","Expenses...K.","Profit...K.","Profit.After.Tax...K.","Profit.Margin....","Good.Month","Bad.Month"
150,80,70,49,33,TRUE,FALSE
120,70,50,35,29,FALSE,TRUE
130,75,55,38,30,FALSE,TRUE
140,85,55,38,28,FALSE,TRUE
160,90,70,49,31,TRUE,FALSE
170,95,75,52,31,TRUE,FALSE
165,93,72,50,31,TRUE,FALSE
155,88,67,47,30,TRUE,FALSE
145,86,59,41,28,FALSE,TRUE
135,78,57,40,30,FALSE,TRUE
